----------------------------------------------------------------------------------------------------
NNXNNNXNNNXXNNXXNNXXNNXXNNNXNWNXNNXKXXXKXXXKXXXKKXXXXXXXXKXXXKXXXXNNNXNNNXXNNXXNNXXNNXXNNXXNNXXNNNXN
NNXXNNXNNNXXNNXXNNXXNNXXNNNXNNNXNNNXNXkodkxddkxddkOkddkkddxkxONNNXNWNXNNNXXNNXNNNXXNNXXNNXXNNXXNNNXN
XNNNXNNNXXNNXNNNXXNNNXNNXXNNNXNNNXNNNk.                     .oNXNNNXNNNXNNNXXNNXXNNXXNNXXNNXXNNXXNNN
WNXNNNXNNNXXNNXXNNXXNNXXNNXXNN0kO0Oxkx;.....................'lO0kkO00KNNNXNNNXXNNXXNNXXNNXXNNNXNNNXN
XNNNXNNNXXNNXXNNXXNNXXNNXXNWNKc.  .  ,kXXXXXXXXXXXXXXXXXXXXXKc   .. ;KNXNNNXXNNXNNNXXNNXXNNXXNNNXNNN
WNXNWNXNNNXXNNXXNNXXNNXXNXxclolccccccdXMMMMMMMMMMMMMMMMMMWMMWkccccccclld0XNNNXNNNXXNNXXNNXXNNXXNNNXN
XNWNXNNNXXNNXXNNXXNNXXNNN0;   oMMMMMMMMMMMMMMMMMMMMMMMMMMMMMMMMMMMMMO. .xWNXXNNXXNNXXNNXXNNXXNNXXNWN
WNXXWNXXNNXXNNXXNNXXNNXXNX;   oMMMMMMMMMMMMMMMMMMMMMMMMMMMMMMMMMMMMMk. .dXXNNXXNNXXNNXXNNXXNWNXNWXXN
XNNNXXNNXXNNXXNNXXNNXXNNN0;   oMMMMMMMMMMMMMMMMMMMMMMMMMMMMMMMMMMMMMk. .xWNXXWNXXNNXXNNXXNNXXNNXXNNX
NNXXNNXXNNXXNNXXNNXXNW0l;:ldddKMMMMMMMMMMMMMMMMMMMMMMMMMMMMMMMMMMMMMXkdoc;;ckXXNNXXNNXXNNXXNNXXNNXXN
XXNNXXNNXXNNXXNNXXNNXXO. .dMMMMMMMMMMMMMMMMMMMMMMMMMMMMMMMMMMMMMMMMMMMMX;   oNNXXNNXXNNXXNNXXNNXXNNX
NNXNWNXXNNXXNNXXNNXXNWO. .dMMMMMMMMMMMMMMMMMMMMMMMMMMMMMMMMMMMMMMMMMMMMX;   oXXNNXXNNXXNNXXNNNXNNXXN
XNNNXXNNXXNNXXNNXXXK00k,..xMMMWXXXXXXXXXXXXXXWMMMMMMMWNXXXXXXXXXXXXXNWMX:...oKKKXNNXXNNXXNNXXNWNXNNX
WNXNNNXXWNXXWNXXNWx,..;x00NMMWo.............'xMMMMMMM0:.............cKMWK00Oc..lXXXNNXXNNXXNWNXNWXXN
XNNNXXNNXXNNXXNNXXd.  '0MMWNNX:              oMMMMMMMO.             'ONNWMMN:  ;KNNXXNNXXNNXXNNXXNNX
NNXNNNXXNNXXNNXXNWd.  'OMNo'''.              dMMMMMMMO.              .';OMMN:  :XXXNNXXNNXXNNXXNNXXN
XNNNXXNNXXNNXXNNXNd.  '0MX:                  dMMMMMMMO.                .xMMN:  ;KNNXXNNXXNNXXNNXXNNN
NNXNNNXXNNXXNNXXNWd.  'OMX:                  dMMMMMMMO.                .xMMN:  :XXXNNXXNNXXNNXXNNNXN
XNNNXNNNXXNNXXNNXNd.  'OMX:                  dMMMMMMMO.                .xMMN:  ;KNNXXNNXXNNXXNNXXNNN
NNXNNNXXNNXXNNXXNNd.  '0MX:                  dMMMMMMMO.                .xMMN:  :XNXNNXXNNXXNNXXNNNXN
XNNNXNNNXXNNXXNNXXOl::cooolcc:.          'ccl0MMMMMMMKoc;.          .;ccoooolc:dXNNXNNNXXNNXXNNXXNNN
NNXNNNXXNNXXNNXXNNXXNWO. .dWMNc         .xMMMMMMMMMMMMMMX;          ,KMK;   oXNNNXXNNXXNNXXNNXXNNNXN
XXNNXNNNXXNNXXNNXXNNXN0l;;ldddl:::::::::c0MMW0dddddddkNMNd::::::::::coddc:;;kNNXXNNXXNNXXNNXXNNXXNNX
NNXXNNXXNXXXNNXXNNXXNNXXNK;   oMWMMMMMMMMMMMNc       '0MMMMMMMMMMMMMk. .dNXNNXNNXXXNXXXNNXXNNXXNNXXN
XNNNXNNXXXNNXXNNXXXXXXXNXXkdolc::dNMMMMMMMMMWc       '0MMMMMMMMMKl::cooo0NXXNNNNXXXXXXXXXNNXXNNXXXNN
NNNNNXXXNXXXNNXXXXNNXXXXNNXXNX:  ,KMMMMMMMMMNc       '0WMMMMMMMMx.  'ONNNXNNNXXNNXXXXXXXXXXXNXXXNNNX
NNNNNXXNNXXXNNXNXXXXNNXNNXXXNX:  ,KMMMMMMMMMWOoooooooxXWMMMMMMMMx.  'ONXXNNNNNXXXXXXXXXXXNXXXNXXXNNN
XXNNXNNNXXXXXXNNXXNNXXNNXXNNNX:  ,KMMMMMMNNNNWMMMMMMMWNXNWMMMMMMx.  'ONXXNNXXNNXXNNXXNXXXNNXXXNXXNNX
NNXXNNXXNNXXXNXXNNXXNNXXNNXXNX:  ,KMMMMMNl..'kMMMMMMM0:.,OMMMMMMx.  'ONNXXXNNXXNNXXNNXXXNXXNNXXNNNXN
XNNNXXNNXXNNXXNNXXNNXXNNXNNNNK:  ;0NNWNNK;   oWNNWWNWk. .dNNNNNWx.  ,0NXNNXXXNNXXNNXXNNXXNNXXNNXXNNN
NNXNNNXXNNXXNNXXNNXXNNXXNNXXNN0kko;''''''    .'''''''.   .'''''':xkxOXNNNXNNNXXNNXXNNXXNNXXNNNXNNNXN
XNNNXNNNXXNNXXNNXXNNXXNNXXNNXXNNNk;.'''..''..''..'''..''..'''.''lKNXNNNXNNNXXNNXXNNXXNNXXNNXXNNXXNNN
NNXNNNXNNNXXNNXXNNXXNNXXNNNXNWNXNNXKXXXKXXXKXXXKKXXXXXXXXKXXXKXXXXNNNXNNNXXNNXXNNXXNNXXNNXXNNXXNNNXN
----------------------------------------------------------------------------------------------------
