                        ######     #######     #####     #     #    ####### 
                        #     #    #     #    #     #    #     #    #       
                        #     #    #     #    #          #     #    #       
                        ######     #     #    #  ####    #     #    #####   
                        #   #      #     #    #     #    #     #    #       
                        #    #     #     #    #     #    #     #    #       
                        #     #    #######     #####      #####     ####### 